NO 
SO 
F 
EA 
C 
WE 


11111
1   0
S
1
1