NO ./textures/test_wall_1.xpm
SO ./textures/test_wall_2.xpm
WE ./textures/test_wall_4.xpm
EA ./textures/test_wall_3.xpm
F 
C 






    1
   1W1
  10001
 1000001
100000001
 1111111