NO ./textures/north.xpm
WE ./textures/west.xpm
EA ./textures/east.xpm
SO ./textures/south.xpm

F 1,0,0
C 0,0,0






    1
   1W1
  10001
 1000001
100000001
 1111111