NO 
SO 
F 
EA 
C 
WE 

    1
   101
  10001
 1000001
1000S0001
111111111