F 255,255,255
C 0,0,0

NO ./textures/north.xpm
WE ./textures/west.xpm
EA ./textures/east.xpm
SO ./textures/south.xpm

1111111111
1000000001
1000011111
100001S001
1000011111
1000000001
1000000001
1111111111
